FakeName	EntityType	Fake
Vanek o.s.	E	1
K. M	I	1
Popescu Gheorghiu and Mocanu	E	1
Perez and Sons	E	1
Rashed Al-Awad	E	1
"Price, Hill and Fletcher"	E	1
Riggs Group	E	1
Nashashibi Ltd	E	1
Štěpánková	E	1
Marsh PLC	E	1
Alam Bin Laden	I	1
Mila Jaafar	I	1
Cook-Jones	E	1
Shehab Mhaideb	I	1
Carol Davis	I	1
Bohumír Zeman	I	1
Elliott-Townsend	E	1
Doherty-Wilson	E	1
Joseph's	E	1
Dr. Mowaffaq Abu Dawood	I	1
Jelínková	E	1
"RAO ""Kalinin-Pakhomov"""	E	1
Li Huan	I	1
Miss Kathleen Wright	I	1
Ruxandra Diaconu	I	1
Garry Bowen-Wilson	I	1
Matthews-Sullivan	E	1
"JSC ""Khokhlova"""	E	1
Gorbunov Mitofan G.	I	1
"Williams, Barnes and Hawkins"	E	1
Traian Suciu	I	1
"Adams, Cunningham and Payne"	E	1
Mcclure-Smith	E	1
"Nankang Science and Technology Co., Ltd."	E	1
Hill-French	E	1
Donna Bailey	I	1
Messenger Buqshan	I	1
Comrade. Kabanova Zinaida Kuzminichna	I	1
Nizar Abu Dawood	I	1
Carter and Sons	E	1
Nemes-Preda	E	1
Amoolh-Amoolh	E	1
"Victoria Wang Ming Technology Co., Ltd."	E	1
Ivan Hájek	I	1
Ostiah-Alagbara	E	1
Wu Bin	I	1
Ruzena Pokorná	I	1
Billy Tucker	I	1
Vlcek	E	1
Jindřiška Cross	I	1
"Fernandez, Martinez and Rodriguez"	E	1
Toukan-Dughmosh	E	1
"Minton Media Co., Ltd."	E	1
Charlene Smith-Parry	I	1
"Al Hussein, LLC"	E	1
Vacková Ltd.	E	1
Turner and Sons	E	1
Severina Dumitrescu	I	1
"JSC ""Merkushev, Diachkov and Kalinin"""	E	1
Callum Ali-Anderson	I	1
"Dai Shuo Electronic Media Co., Ltd."	E	1
Ms. Mason Al Atfet	I	1
Tomas Zeman	I	1
Reyes Inc	E	1
Marian Pokorny	I	1
"Roberts, Young and Perez"	E	1
Zhang Jun	I	1
Pavlína Benešová DiS.	I	1
Hodges-Solis	E	1
Castro LLC	E	1
Mr. Allam Kano	I	1
Zeno Dochioiu	I	1
Marek Blaha o.s.	E	1
Pospisil	E	1
Juffali Group	E	1
Al-Ali Al-Atfet	E	1
Erythema PLC	E	1
"Roberts, Thomas and Riley"	E	1
Stan Ltd	E	1
Haley Inc	E	1
Mr. Duncan Harvey	I	1
"Al-Sheikh, Al-Ali and Al Hussein"	E	1
"JSC ""Golubeva Costin"""	E	1
"New Yulong Information Media Co., Ltd."	E	1
James Flores	I	1
Florea Popescu and Ionescu	E	1
Muhaidib and Sons	E	1
"Lingying Information Co., Ltd."	E	1
Jenna Murray	I	1
Alena Procházková	I	1
Henrieta Mocanu	I	1
Sydney Lucas	I	1
Huang Feng	I	1
Chen Guifang	I	1
Bennett-Ford	E	1
Florea Group	E	1
Roy Anderson	I	1
Joy Sharbatly	I	1
Blažková Inc.	E	1
Elizabeth Nathanovna Sharapova	I	1
Iris Aanei	I	1
Natalya Rusakova Arkadievna	I	1
Dinu Georgescu	E	1
Alexander Vanek	I	1
Ozana Nistor	I	1
Brussels Novotny Inc.	E	1
Cornelius Thomas	I	1
Al Safwan LLC	E	1
Cheng Jing	I	1
Zhou Lei	I	1
Valentin Sysoev Efremovich	I	1
"Bryant, Jones and Green"	E	1
"NGO ""Savelyev"""	E	1
Dr. Bahia Ostiah	I	1
Blokhin Ltd.	E	1
Muhanna Al-Ayed	E	1
Filatov Group	E	1
Tamara Zhdanovna Muraveva	I	1
Smith Group	E	1
"Hewitt, Reeves and Barrett"	E	1
Abboud Almhaolh	I	1
Sakakini-Tamimi	E	1
Jonathan Leonard	I	1
Al Military PLC	E	1
Engineer Aseel Abu Dawood	I	1
Page-Walls	E	1
Engineered tunes tractor	I	1
Asim Al Ayed	I	1
"JSC ""Veselova-Seliverstov"""	E	1
Michael Small	I	1
"Zitawi, Salehi and Toukan"	E	1
Suzanne Thompson	I	1
Radka Zemanová	I	1
Kuzmin Egor Trifonovich	I	1
Koyo	I	1
Jason Scott	I	1
Praskovya Nathanovna Kiseleva	I	1
Lin Shulan	I	1
Tim Ball	I	1
Dr. Carly Patel	I	1
Rustam Alaghbary	I	1
"Georgescu, Nita and Oprea"	E	1
LADGHAM-Abu Hqdm	E	1
Aneta Kratochvílová	I	1
Borislav Tarasovich Bragin	I	1
Abu Qamar-Salhi	E	1
Sarah Nicholson	I	1
Hana Jandová	I	1
"White, Thompson and Delacruz"	E	1
Nistor Stan and Dochioiu	E	1
Lucas Group	E	1
Mr. Shawki Zitawi	I	1
Badr-cross	E	1
James Soto	I	1
Professor Lama Alzeidanah	I	1
Nelson LLC	E	1
Thomas Leonard	I	1
Voentorh	E	1
"FE ""Biryukova Ermakova"""	E	1
Bradley-Harris	E	1
Professor Thaqeef Nashashibi	I	1
Callahan and Sons	E	1
"CJSC ""Subbotin"""	E	1
Kano Al-Hussein	E	1
Kelly Delacruz	I	1
Mrs. Jodie Poole	I	1
Laura Cameron	I	1
Rene Novotny	I	1
Trends Network Ltd.	E	1
Richard Mason	I	1
Zuzana Horakova	I	1
Eftimie LLC	E	1
Martin Ruzicka	I	1
Nasri Xuana	I	1
Howard-Walters	E	1
Fiala a.s.	E	1
Christina Murphy	I	1
"Hnbola, Al Moaidh and faction"	E	1
Puşcaşu Albu and Tudor	E	1
Oana Gheorghiu	I	1
Donna Kelly	I	1
Porphyry Arsen'evich Avdeev	I	1
Olivia Gibson	I	1
"Think of Technology Co., Ltd."	E	1
Pakhomov Incorporated	E	1
Donna Arnold-Thompson	I	1
King Ltd.	E	1
Hájková Ltd.	E	1
Gianina Albu	I	1
Thomas Mills	I	1
"Doyle, Matthews and Hart"	E	1
Ms. Ahlam Dughmosh	I	1
Rose-McDonald	E	1
Smith Inc	E	1
Ms. Ryan Salhi	I	1
Engineer Kazem Abu Qamar	I	1
Katie Smith	I	1
Professor increases Buqshan	I	1
Smith PLC	E	1
Vaňková Vaňková o.s.	E	1
"CJSC ""Yudin, Sukhanov and Mironov"""	E	1
"Burgess, Hays and Curry"	E	1
Aleodor Aanei	I	1
Foreign exchange Network Ltd.	E	1
Horton-Ramirez	E	1
"Salehi, Khoury and Hosah"	E	1
Fedoseyev and partners	E	1
Evans-Bryan	E	1
"Hong Rui Sibo Information Co., Ltd."	E	1
"Shelton, Hunt and Davis"	E	1
Burton Ltd	E	1
Professor Bahia Nashashibi	I	1
Of Concerning	I	1
Novak	E	1
Jennifer Mccoy	I	1
Wade and Sons	E	1
Li Li	I	1
Eftimie Inc.	E	1
"Rankin Electronic Technology Co., Ltd."	E	1
Package Jinfeng	I	1
Stewart James-Gardiner	I	1
"Owen, Jones and Webb"	E	1
Hartley and Sons	E	1
Muhanna Abu-Dawood	E	1
Alagbara PLC	E	1
Marie Waters	I	1
Glenn Garrett	I	1
"Martinez, Rodriguez and Thompson"	E	1
"FE ""Sysoev"""	E	1
Shukri Al-Saud	I	1
Leonid Ershov Eliseevich	I	1
Lydia Gregory	I	1
"Brooks, Christensen and Jones"	E	1
"E-Power Co., Ltd."	E	1
Scott Smith	I	1
"Dong Fang Junjing Media Co., Ltd."	E	1
Peterson and Sons	E	1
Ovchinnikov Gordey Gertrudovich	I	1
David Rubio	I	1
Daniel Hajek	I	1
Zhu Jianjun	I	1
Julia Moore	I	1
Jennifer Barnett	I	1
Oliver Inc	E	1
Shaw Ltd	E	1
"Tabacu, Nemes and Popescu"	E	1
Popa Patru	I	1
Niphon Evseevich Mukhin	I	1
"Alvarez, Reeves and Johnson"	E	1
Michael Brown	I	1
Smoke-Nemes	E	1
Chapman-Power	E	1
Matthew Porter	I	1
"Love, Bell and Kirk"	E	1
Jessica Saunders	I	1
Graham LLC	E	1
Matilda Popa	I	1
Nael Al Mohammed bin Ali bin Jammaz	I	1
the Group	E	1
"Wan Xun Computer Media Co., Ltd."	E	1
Linda Gutierrez	I	1
Finley Group	E	1
Guzman and Sons	E	1
Terry Lopez	I	1
Maxim Puşcaşu	I	1
Stevens-Tucker	E	1
Miss Kawthar Amoolh	I	1
Ms. Helen Robinson	I	1
Powell-Day	E	1
Tractor-Zitawi	E	1
Elena Kovaleva Kuzminichna	I	1
Kevin Salinas	I	1
Dr. Cheers Bin Al Wafi	I	1
Li Chunmei	I	1
John Sloan	I	1
Eliza Barbu	I	1
Jarmila Růžičková	I	1
Ayala PLC	E	1
Brittney Jones	I	1
Agatha Oskarovna Davydova	I	1
"Mahyar, Tarabin and Dughmosh"	E	1
"NGO ""Teterin, Tretyakov and Thunder"""	E	1
Harris LLC	E	1
"Barghouti, Mahyar and Tarabin"	E	1
Grishina Laura Vladislavovna	I	1
Rene Benes	I	1
Sultan Al-Muhaidib	E	1
"RAO ""Sitnikov Ponomareva"""	E	1
Vratislav Masek	I	1
Badr Inc	E	1
"Victoria Tao Media Co., Ltd."	E	1
Jasmina Popa	I	1
Dima PLC	E	1
Şerban Ene	I	1
Ms. Darren Al Mokth	I	1
Marcel Diaconu	I	1
Ponomarev Averky Bronislavovich	I	1
Lebanon Abu Hbak	I	1
Likhachev Radovan Iosipovich	I	1
Miss high faction	I	1
Walsh-Taylor	E	1
Craig Wilcox	I	1
Daiana Stancu	I	1
Abu Mahjoub Hbak	I	1
Aba PLC	E	1
Amoolh-Aba	E	1
"Ross, Brewer and House"	E	1
Suzanne Bradley-Harrison	I	1
Abu Qamar-Shaheen	E	1
Shaheen-Khammash	E	1
Morrow and Sons	E	1
Alexandra Kučerová	I	1
Alnnih Group	E	1
Marešová o.s.	E	1
Victoria Tao Network Ltd.	E	1
"Almhaolh, Al Awad and Hukair"	E	1
Dlahh and Sons	E	1
Angela Y. Konovalov	I	1
Machová	E	1
Hosah-Abu Sneineh	E	1
"Stone Technology Co., Ltd."	E	1
Erythema-cross	E	1
Ms. Angela Hudson	I	1
Nicholas Ababei	I	1
World Year Development Network Ltd.	E	1
Deborah Stevens	I	1
Hajek	E	1
Lorraine Green	I	1
World Feofanovich Petukhov	I	1
Dr. Sara Jarvis	I	1
Bates Ltd	E	1
"CJSC ""Savelyev-Kononov"""	E	1
Niculiţă Popescu	I	1
Liu Hao	I	1
What rock	I	1
"Georgescu, Tomescu and Albu"	E	1
Surrender Diaconu	E	1
Mrs. Al-Awad innovation	I	1
"Hong Rui Sibo Information Co., Ltd."	E	1
Ligia Voinea	I	1
Jennifer Adams	I	1
"Tamimi, Shaheen and tractor"	E	1
Neftehimremstroy	E	1
Home Credit and Finance Bank (PPF)	E	1
"Jones, Moore and Johnson"	E	1
Oliver Inc	E	1
Kate Reed	I	1
Anthony Schmidt	I	1
"Horse father, Abu Dawood and al-Dabbagh"	E	1
"Zitawi, Dughmosh and Shaheen"	E	1
Black-Grimes	E	1
Ionita Inc.	E	1
"JSC ""Prokhorov-Rusakov"""	E	1
Al Bin Zafar and Sons	E	1
Marie Benesova	I	1
Carr-Mcguire	E	1
Al-Sheikh Inc	E	1
Suciu-Nita	E	1
Melissa Carrillo	I	1
"Founder Technology Information Co., Ltd."	E	1
Florea-Nistor	E	1
Maya Nathanovna Likhachev	I	1
Sandra Jones	I	1
"CJSC ""Filatov Tretyakov"""	E	1
Engineer Dhabi Alnnih	I	1
Alzeidanah-Hashem	E	1
"Bin Laden, Al-Sheikh and Al military"	E	1
Chao Yi Network Ltd.	E	1
Engineer Kamal Hnbola	I	1
Nissan Hajjar	I	1
Miloslav Novotny	I	1
Ioniță PLC	E	1
"Environment Technology Co., Ltd. million points"	E	1
Clark-Rogers	E	1
"Davies, Garner and Jones"	E	1
Ellie Williams	I	1
Kadlec o.s.	E	1
Kolesnikov Inc.	E	1
"Dughmosh, a cross and Alzeidanah"	E	1
"French, Horton and Garza"	E	1
Benes	E	1
Mr. Ionescu	I	1
Liu Ying	I	1
"Jones, Smith and Hopkins"	E	1
Charles Brown	I	1
"Al Atfet, Mhaideb and Jaafar"	E	1
Dima minodora	I	1
Chelsea Walton	I	1
Miss Judy Aqeel	I	1
Robson and Sons	E	1
Miss GUERETS Amoolh	I	1
Mohammad Murray	I	1
Brussels Kucera Ltd.	E	1
"NGO ""Emelyanov"""	E	1
Victor Bryan	I	1
Pospíšil Ltd.	E	1
Morris-Bradford	E	1
Logan-Wells	E	1
"Of ""Samson"""	E	1
jennifer Soto	I	1
John Gilbert	I	1
"LLC ""Seliverstov"""	E	1
"Dima, Nita and Cristea"	E	1
Lina Al Bin Zafar	I	1
"Lingying Information Media Co., Ltd."	E	1
Lewis Ltd	E	1
Pospíšilová	E	1
Michaela Kadlecová	I	1
Scott Sweeney	I	1
Jemma Hammond	I	1
Dr. Retag Marmash	I	1
Haynes LLC	E	1
Ms. Barghouti Ghaida	I	1
Wang Tao	I	1
Decebal Aanei	I	1
Eliseeva Apollynaryy Antypovych	I	1
The first heavy weight company	E	1
Chao Yi Network Ltd.	E	1
Ardelean-Oprea	E	1
Hussain-Andrews	E	1
Kayla Ford	I	1
"JSC ""Volkov-pancake"""	E	1
Joshua Patterson	I	1
Jerry Smith	I	1
"Diaconescu, Dobre and Dima"	E	1
Al-Bin Dhafer Al Ali	E	1
Dumitrescu Dumitrescu and Stoica	E	1
Hernandez LLC	E	1
Edwards PLC	E	1
Wilson-Hart	E	1
Mr. Hassan Salehi	I	1
"Mckee, Douglas and Johnson"	E	1
Franklin Inc	E	1
Jean Johnson	I	1
Bishop-Bradley	E	1
"Walton, Moore and Richards"	E	1
Jill Rivas	I	1
Ashley Pollard	I	1
Raed Al-Sheikh	I	1
Theodore Werner	I	1
Jean Brown	I	1
Georgel Good	I	1
Joan Bailey	I	1
Marcela Cross	I	1
Lioara Flat	I	1
Ioniță and Sons	E	1
Jarmila Králová	I	1
Engineer Kased Hnbola	I	1
Barnes PLC	E	1
Francesca Puşcaşu	I	1
Dean PLC	E	1
Odintsov Naum Edgardovich	I	1
"Figure Dragon Information Technology Co., Ltd."	E	1
Sanded Xuana	I	1
Hind Al-Muhanna	I	1
Luo Hongmei	I	1
Horakova Ltd.	E	1
Čermáková	E	1
"Kelly, Neal and Franco"	E	1
Dinu Gheorghiu and Stoica	E	1
Schwartz-Newman	E	1
Andrew Cunningham DVM	I	1
Mrs. Frances Webb	I	1
Dominic Diaconu	I	1
Miss Beautiful Toukan	I	1
Mares Ltd.	E	1
Mr. Al Ali	I	1
Libuse Čermáková	I	1
"Cook, Powell and Bell"	E	1
Theresa Porter	I	1
Myasnikov Pelagia Veniaminovna	I	1
Filip Mašek	I	1
Kharafi-Juffali	E	1
All bin amer_silver LLC	E	1
Rebecca Clark	I	1
Tudor Florea Diaconu and	E	1
Daniel Daniels	I	1
Anthony Stephens	I	1
Yang	I	1
Andreev Bazhen Venediktovich	I	1
"JSC ""Ryabov Smirnova"""	E	1
Al Awad Ltd	E	1
Czeslaw Efstafevich Dmitriev	I	1
"Bennett, Thompson and Collins"	E	1
Alexander PLC	E	1
Thaqeef Sharbatly	I	1
Maskova	E	1
Sedláček	E	1
Dr. Elizabeth Hunter	I	1
In force Al Ali	I	1
"Porter, Rowe and Wilson"	E	1
Chan Kwai Lan	I	1
Powell Inc	E	1
Davydova Daria Antonovna	I	1
Woods-Johnson	E	1
Alberta Nistor	I	1
Terence Graham-Dixon	I	1
Charles West	I	1
Little Lucie	I	1
Latoya Parsons	I	1
Říhová	E	1
Gheorghiu-Pop	E	1
Junaidi-Khammash	E	1
Maximilian Dima	I	1
Gardner-Holloway	E	1
Johns and Sons	E	1
Pop-Tomescu	E	1
"Time and space box Digital Technology Co., Ltd."	E	1
Tala Khammash	I	1
Wright Inc	E	1
Diaconescu and Sons	E	1
Baker Group	E	1
Jeffrey Gill	I	1
Moradi Butcher	I	1
Arthur Andrews-Thomas	I	1
Blažková Masek Ltd.	E	1
Ms. Rima Al Atfet	I	1
Naina A. Evseev	I	1
Mr. Alan Harrison	I	1
Amur tank farm	E	1
Myasnikov Mikhail E.	I	1
Ltd tick	E	1
Wu Xu	I	1
Hafez Al Hajar	I	1
Arthur Williams	I	1
Butcher Ltd	E	1
"Albu, Tudor and Stanescu"	E	1
Julia Barghouti	I	1
"JSC ""Subbotina"""	E	1
Henderson-Powers	E	1
Tiberiu Ardelean	I	1
Ronin	I	1
Yin Chen	I	1
Vasile Ionita	I	1
Human Sharbatly	I	1
Kopecký	E	1
Romina Ionita	I	1
Akim Zakharievich Gerasimov	I	1
United Soft Network Ltd.	E	1
"Meyers, Manning and Stephens"	E	1
Dabbagh Gilan	I	1
Jose Griffith	I	1
Yudina Group	E	1
Milovan Harlamovich Abramov	I	1
Dana Hajjar	I	1
Marin Ilie	I	1
Gheorghiu Mitruţ	I	1
Tami Mueller	I	1
Wilson-Sharp	E	1
Taylor-Reynolds	E	1
"Jaafar Al, Al Hussein and professions"	E	1
Zhang Ying	I	1
Cynthia Simpson	I	1
Robert Williams	I	1
Wang Ming-dimensional information Limited	E	1
Stoica Dinu	E	1
Smith-Murray	E	1
Mike Vargas	I	1
Jones Ltd	E	1
Alagbara-Hosah	E	1
Crystals Crystals	I	1
Given Khammash	I	1
Dr. Huda Abu Hbak	I	1
Frederick Hunter-Coleman	I	1
Ms. Nawal Abu Hbak	I	1
Khaldi Badr	I	1
Dima Inc	E	1
"Dima, Mocanu and Tabacu"	E	1
Al-Jaber Al-Wafi and Bin Muhanna	E	1
Gina Hawkins	I	1
Evgeny Osipov Tarasovna	I	1
"Hunt, Carrillo and Garcia"	E	1
Angela Rubenovna Makarov	I	1
Masek Ltd.	E	1
Diana Albu	I	1
Fida faction	I	1
Adrian Briggs-Brown	I	1
Smooth Alzeidanah	I	1
Juan	I	1
Kolar Ltd.	E	1
Voinea Diaconu and Popescu	E	1
Aref Avdeevich Terentyev	I	1
"Alshaya, Sharbatly and Sharbatly"	E	1
"Ryan, White and Cook"	E	1
Wu Ming	I	1
Al Bin Al-Wafi Short	E	1
Alexander Russell	I	1
Crawford-Pena	E	1
"Sanders, Allen and Bell"	E	1
"Miller, Neal and Smith"	E	1
Terentyev Maria S.	I	1
Abu pipe-Badr	E	1
"Huacheng Yu Zhuo Technology Co., Ltd."	E	1
"Stoica, Marin and Pop"	E	1
Tamimi-Fatayer	E	1
Short-Shaffer	E	1
Pospíšilová Novak o.s.	E	1
Panqian	I	1
Maskova	E	1
"Junaidi, Hosah and Badr"	E	1
Ramirez-Brown	E	1
"JSC ""Turov"""	E	1
Carp Vikentievich Melnikov	I	1
Smith-Hurst	E	1
Mrs. Lynda Davies	I	1
Vinogradov Nathan F.	I	1
Dabbagh-faction	E	1
Tina King	I	1
Ryabov Ivanna Pavlovna	I	1
Aida Dumitrescu	I	1
"Anderson, Harrell and Morales"	E	1
"Davies, Davies and Turner"	E	1
Professor increases Alzeidanah	I	1
Williams-White	E	1
"JSC ""Rozhkov Odintsov"""	E	1
FMSM (PMI)	E	1
"Salehi, LADGHAM and Alzeidanah"	E	1
Sloan-Watts	E	1
Burns Group	E	1
Hudson-Anderson	E	1
Carly Kennedy	I	1
Salhi Inc	E	1
Salhi-Shaheen	E	1
Ionut Stan	I	1
Lin Cheng	I	1
Leslie Roberts	I	1
Libuše Svobodová	I	1
Boris Potapov Afanasievich	I	1
Florea maricica	I	1
Ms. Iman Al-Saud	I	1
Glen Cox	I	1
Libuše Říhová	I	1
"Olayan, Sharbatly and Al-Rashed"	E	1
John Clark	I	1
Al Mokth PLC	E	1
"Slater, Howarth and Clarke"	E	1
Dima Sânziana	I	1
Engineer Hassanein Khoury	I	1
Mr. Jack Armstrong	I	1
"Parker, Jones and Lloyd"	E	1
Huacheng Yu Zhuo Network Ltd.	E	1
"JSC ""Medvedev Ants"""	E	1
Fu Xiulan	I	1
"E-Power Technology Co., Ltd."	E	1
"Hood, Garrison and Robles"	E	1
Mr. Terry Wood	I	1
Mrs. Francis Doe	I	1
Jaromír Mareš	I	1
Zhu Yan	I	1
Hashim al-Husseini and Abu pipe	E	1
Austrian media giant Ltd.	E	1
"When Unicom Branch Information Co., Ltd."	E	1
Ksvany Inc	E	1
"Juphoon Information Co., Ltd."	E	1
"Graham, Mcgee and Stewart"	E	1
Mr. Olayan Habbab	I	1
Breeze	E	1
Williams-Morton	E	1
"CJSC ""Mukhin Mukhina"""	E	1
"E-Power Co., Ltd."	E	1
Hashem-tick	E	1
Andrew Cox	I	1
James Byrd	I	1
Cristea Dochioiu and Ionescu	E	1
Ok Jaffali	I	1
Janda Inc.	E	1
Riha Inc.	E	1
Cermak Cross Ltd.	E	1
The professor Novikov Askold	I	1
Callum Ahmed	I	1
Ms. Nardin LADGHAM	I	1
Eftimie Ardelean	I	1
Williams-Mullins	E	1
dhman aladghm	I	1
Al Moaidh PLC	E	1
Port Al Short	I	1
Xia hole	I	1
Ostiah PLC	E	1
Aleš Blažek	I	1
"JSC ""Fomin"""	E	1
Alshaya and Sons	E	1
Dr. Ibtihal Al Mokth	I	1
Castaneda-Reid	E	1
Almhaolh LLC	E	1
Benes	E	1
Jones-Ward	E	1
Cats Panteleimon Frolovich	I	1
Hajjar Ltd	E	1
Anderson PLC	E	1
Jake Brown	I	1
Dr. Liam Shaw	I	1
Yin Jianhua	I	1
West LLC	E	1
"Chang, Dorsey and Shah"	E	1
Stan LLC	E	1
Dr. Nasri Tarabin	I	1
Alexandrova Ekaterina Makarova	I	1
Mitchell Williams	I	1
Zeng Ling	I	1
"Digital Information Co., Ltd. 100"	E	1
"Victoria Wang Ming Technology Co., Ltd."	E	1
Jean Morris	I	1
Bauer Inc	E	1
Říhová	E	1
"Al-Askari, Al Saud and Hnbola"	E	1
Dr. Muslim Hukair	I	1
"LLC ""Abramov Popov"""	E	1
Engineer Hassan Al Short	I	1
"Year of the Century Media Co., Ltd."	E	1
Jaafar Al-Abu Dawood	E	1
Cheerful Ltd.	E	1
"Mitchell, Russell and Khan"	E	1
"Ababei, and Tudor Florea"	E	1
Panov Bazhen G.	I	1
Dvorakova Inc.	E	1
Al-Al short military	E	1
Abu Hbak-Barghouti	E	1
Holloway and Sons	E	1
Dinglu	I	1
Fatayer-LADGHAM	E	1
Leah White	I	1
Mocanu-Ababei	E	1
Autumn Grimes	I	1
YANG Ting-ting	I	1
Albu Nistor and Voinea	E	1
"Al-Sheikh, Al-Kharafi and Khudair"	E	1
Julie Johnson	I	1
Lebedeva Vera L.	I	1
Faina Kiseleva	I	1
"Lixin Electronic Media Co., Ltd."	E	1
Ragheb Dlahh	I	1
Vasily Anufrieviç Gushchina	I	1
Sullivan Inc	E	1
"Stone Media Co., Ltd."	E	1
Stoica Tabacu	E	1
Richardson and Sons	E	1
Hou Lijuan	I	1
"A billion Media Co., Ltd."	E	1
Metal Company Profile	E	1
Gloria Flores	I	1
Sibuglemet	E	1
News and Media Limited	E	1
"Liu, Andrews and Ramirez"	E	1
Petre Nistor	I	1
Zemanová Sedláček Ltd.	E	1
Nemcova Blahova o.s.	E	1
"Clarke, Rees and Khan"	E	1
Mhaideb LLC	E	1
Rogers and Sons	E	1
Mr. Roy Cole	I	1
Mr. Bruce Hopkins	I	1
Hannah Harris	I	1
Abu-tick Hbak	E	1
Kevin Anderson	I	1
"Anderson, Adams and Webster"	E	1
Lawrence Knight	I	1
Invocation faction	I	1
"Sakakini, Hambali and Nusseibeh"	E	1
Nader Al Khudair	I	1
Miss Port Alnnih	I	1
Hashim LLC	E	1
Ionescu Stoica	E	1
Bretislav Bartos	I	1
Štěpánková	E	1
Nam Network Ltd.	E	1
Dr. Matthew Lowe	I	1
Naji Jaffali	I	1
Tammy Pineda DVM	I	1
Lazarus Mocanu	I	1
Aqeel and Sons	E	1
Bentley-Chadwick	E	1
Lucie Soukupová	I	1
"Abu Amar, Fatayer and Ostiah"	E	1
Mammoth Demid Erofeevich	I	1
Griffiths PLC	E	1
"JSC ""Kolesnikov-Shilov"""	E	1
Amelia Mistry	I	1
Yakov V. Blinov	I	1
Shchukin Gavrila Denisovich	I	1
Novotna Ltd.	E	1
Professor Bilqis Al Mohammed bin Ali bin Jammaz	I	1
Mikhailov Inkorporэyted	E	1
Michal Polák	I	1
Brian Odonnell	I	1
Shawn Navarro	I	1
Diana Gardner	I	1
Professor Karma Khazen	I	1
Toma and Sons	E	1
Adrian Dima	I	1
Tomescu Ardelean and Stoica	E	1
Trance bin Al Wafi	I	1
"Year of the Century Media Co., Ltd."	E	1
"Freeman, Brown and Norton"	E	1
Engineer Sadiq Khammash	I	1
Olayan LLC	E	1
News and Media Limited	E	1
Wafiq Al-Kharafi	I	1
Autotor holding	E	1
"Williams, Robinson and Carroll"	E	1
"Adams, Parker and Robinson"	E	1
Karim Al-Mohammed bin Ali bin Jammaz	I	1
"JSC ""Shchukin Kuznetsov"""	E	1
Diaconu Tabacu and Diaconescu	E	1
Emily Graham	I	1
Vit Holub	I	1
Stoica Mazilescu	E	1
Edwards LLC	E	1
Stancu PLC	E	1
Mr. Shane Gaines	I	1
Riha Krejčová Inc.	E	1
Happy o.s.	E	1
Velimir Yakubovich Loginov	I	1
Tailor o.s.	E	1
"Year of the Century Information Co., Ltd."	E	1
"Demone Information Co., Ltd."	E	1
Alexandra l i	I	1
Liam Hall	I	1
Engineered Retag Alagbara	I	1
Soft crown of Business Information Ltd.	E	1
"Vega, Brewer and Oneill"	E	1
Fernandez-Roberts	E	1
Mironov Limited	E	1
"Velez, Flores and Boyer"	E	1
Luxury Dughmosh	I	1
Professor Rittal faction	I	1
Brandon Lewis	I	1
"Al Hussein, Al-Saud and Almhaolh"	E	1
Muhanna PLC	E	1
Laura Michael	I	1
Cohen-Pollard	E	1
Dr. Emily Williams	I	1
"Powell, Patel and Jones"	E	1
Olayan Inc	E	1
John Collins	I	1
Newton Ltd	E	1
Chan-Wood	E	1
Khayat Ltd	E	1
Răzvan Marin	I	1
Lindsay Austin	I	1
Marcus Samuel	I	1
Dima LLC	E	1
Julian Filimonovich Rusakov	I	1
"RAO ""Kudryavtsev, Selezneva and Vasiliev"""	E	1
Mora PLC	E	1
Jinyang	I	1
Sloan-Weeks	E	1
Inspiring faction	I	1
"Hale, Davis and Barton"	E	1
Chen Jun	I	1
"Lingying Information Media Co., Ltd."	E	1
Giant Olympic Network Ltd.	E	1
Al Hussein and Al Sharbatly Mokth	E	1
Yemelyanov Vera Ivanovna	I	1
Stephanie Baker	I	1
Vaňková	E	1
"RAO ""Markov-Belyaeva"""	E	1
PLC tick	E	1
Johnson Inc	E	1
"Lee, Perkins and Johnson"	E	1
Al Saud Group	E	1
Badr-Khazen	E	1
Salary professions	I	1
"RAO ""Golubeva-Kozlov"""	E	1
Sidonia Ionita	I	1
Andrea Watson	I	1
Keep Nashashibi	I	1
Matveeva Nonna Vyacheslavovna	I	1
Breeze	E	1
Professor encounter tractor	I	1
Vit Benes	I	1
OAO «Savina»	E	1
"RAO ""Vlasov-Nikiforov"""	E	1
Codrin Nemes	I	1
Cosmina Stancu	I	1
Hancock Inc	E	1
Moore Group	E	1
Aanei and Sons	E	1
"NGO ""Kornilov, Doronin and Selezneva"""	E	1
Douglas Wilkinson	I	1
Yang Palace	I	1
Slav Muhammad bin Ali bin Jammaz	I	1
Irfan Salehi	I	1
Mihai Stanescu	I	1
Ezzedine Shaheen	I	1
Ababei-Tabacu	E	1
"CJSC ""Terentiev Terentiev"""	E	1
Mark Ramirez	I	1
Lyudmila Molchanova Zhdanovna	I	1
Leslie Poole	I	1
Karen Brown	I	1
Raven Jennings	I	1
Uvarov Ladimir Artemovich	I	1
Konovalov Dementii Fedosevich	I	1
Troy Rojas	I	1
Tractor-erythema	E	1
Copeland-Holland	E	1
Radek Kratochvíl	I	1
Wang Yumei	I	1
Mr. Assem erythema	I	1
"FE ""Danilov Kovalev"""	E	1
Kuznetsov Savely Valer'yanovich	I	1
Christopher Doyle	I	1
OOO «Naumov»	E	1
Ilina Alla Vladimirovna	I	1
Ababa Ababei and Dumitrescu	E	1
Bohumil Machová	I	1
Joyce Kay-Watson	I	1
Yang Chunmei	I	1
"Hui sent International Technology Co., Ltd."	E	1
"Scott, French and Hall"	E	1
Kimberly Taylor	I	1
"Jennings, Martinez and Evans"	E	1
"Tractor, Ostiah and Turkmen"	E	1
Chapman Inc	E	1
Gabriel Rasmussen	I	1
Nashashibi-Alnnih	E	1
Dr. Memon Al Mokth	I	1
Adéla Čermáková	I	1
Junaidi LLC	E	1
"NGO ""Zykov, Fedotov and Shilov"""	E	1
Tikhon Davidovich Rogov	I	1
"Abu pipe, the butcher and the butcher"	E	1
Marešová	E	1
"ZAO ""Moiseev"""	E	1
"Jaafar Al, and Al Buqshan Bin Zafar"	E	1
Professor of abused Abu Hqdm	I	1
Manole Augustin	I	1
Brandon Watson	I	1
Yang Ting	I	1
Sabrina Dumitrescu	I	1
"Neumann Network Software Co., Ltd."	E	1
Brandon Reyes	I	1
Ms. Abu Jahra Hqdm	I	1
Tiankai Network Ltd.	E	1
Patricia Dinu	I	1
Albu-Ardelean	E	1
Octavia Ionita	I	1
Aguilar-Harris	E	1
Mr. Al-high structure	I	1
"O'Brien, Hughes and North"	E	1
Kondratiev Limited	E	1
"On the occasion were Union Media Co., Ltd."	E	1
Cook Ltd	E	1
Markéta Mašková	I	1
Alicia Church	I	1
"Huayuan Software Information Co., Ltd."	E	1
Brenda Waters	I	1
Amalia Nemes	I	1
Duncan Inc	E	1
Badr Inc	E	1
Afnan Al-Muhanna	I	1
John Boyd	I	1
Velasquez-Mcdaniel	E	1
"Nashashibi, Turkmen and Khoury"	E	1
Dr. Charter Amoolh	I	1
Alexis Jensen	I	1
Dr. Ashley Howells	I	1
Engineer Dima Toukan	I	1
"Smith, Hubbard and Kerr"	E	1
Ms. joy Hosah	I	1
Soukupová Inc.	E	1
Happy	E	1
Hajjar unscathed	I	1
Gary Jordan	I	1
Mr. Hussein Al-Khalidi	I	1
Lin Guirong	I	1
Daniel Hansen	I	1
"Huff, Phillips and Sherman"	E	1
Dr. fully tick	I	1
Thomas Orozco	I	1
Georgel Aanei	I	1
"Cox, King and Greenwood"	E	1
Jan Mareš DiS.	I	1
Nita Mocanu and Georgescu	E	1
Tala Al-Rashed	I	1
"Clark, Macdonald and Juarez"	E	1
Gilmore-Sanchez	E	1
Knight and Sons	E	1
"LLC ""Vasilyeva Zhukov"""	E	1
"JSC ""Lytkina-Odintsov"""	E	1
Chi Chang	I	1
Pospisil	E	1
Wu Yuying	I	1
"Dima, and Marin Ardelean"	E	1
Sheikh Al-Muhanna	E	1
Diaconescu Group	E	1
Michelle Figueroa	I	1
Kelly Fields	I	1
Marin Tudor and Tabacu	E	1
Ladislav Black	I	1
Stacey Ferrell	I	1
Florea Group	E	1
Patricia Maldonado	I	1
Cheng Yuying	I	1
"Bell, Myers and Lopez"	E	1
Large Tarabin	I	1
Rogov G. Euphrosinia	I	1
"Think of Technology Co., Ltd."	E	1
Vacková Inc.	E	1
Abramov and Partners	E	1
Saad Al-Rashed	I	1
Professor Wafaa Buqshan	I	1
Arkhipov Eustace Terent'evich	I	1
Sara Carpenter	I	1
Gianina Cristea	I	1
Nichifor Puşcaşu	I	1
Miss Meyer Bin Al Wafi	I	1
"Pu City Public Information Co., Ltd."	E	1
Engineer William Ostiah	I	1
"Abu Hbak, Alzeidanah and Fatayer"	E	1
"JSC ""Anisimova-Matveev"""	E	1
Ms. Lulea Ajlan	I	1
Esparza Ltd	E	1
Shannon Mccormick	I	1
Bahia Hashem	I	1
Mark Charles	I	1
"E-Power Information Co., Ltd."	E	1
Mr. Frederick Watkins	I	1
"Smith, Jones and Carter"	E	1
Osip Vilorovich Kostin	I	1
Ms. Lulea Al Bin Wafi	I	1
Stone Network Ltd.	E	1
"Ionita, and Eftimie Georgescu"	E	1
Thomas-Hicks	E	1
Anahid Alzeidanah	I	1
TEK Mosenergo	E	1
Zayed Ostiah	I	1
Nicole Mcdonald	I	1
Alina Popescu	I	1
"Tiankai Media Co., Ltd."	E	1
"Bin Laden, Kano and Hajar"	E	1
Engineer Hanafi Al-Sheikh	I	1
Brandon Graham	I	1
Victor Dochioiu	I	1
"Morgan, Myers and Conway"	E	1
Wang Fenglan	I	1
Libor Blažek	I	1
"Wan Xun Computer Media Co., Ltd."	E	1
Ales Bartos	I	1
Shaun Hughes-Green	I	1
Brian Bishop MD	I	1
"Al-Saud, Inc"	E	1
Murphy PLC	E	1
Daniel Hammond-Jackson	I	1
Dochioiu Oprea and Dima	E	1
Wang Hui	I	1
Allen Abu Dawood	I	1
Holubová	E	1
Augustina Suciu	I	1
Rivas-Brown	E	1
"Fidelity Zhi Yuan Information Co., Ltd."	E	1
Hatem Salhi	I	1
"Time and space box Digital Technology Co., Ltd."	E	1
Yujie	I	1
Al-Ali Al-Sheikh	E	1
Ababei and Sons	E	1
Ing. Jaroslava Pospíšilová Ph.D.	I	1
Dr. Riemann Hajjar	I	1
Bedrich Nemec	I	1
Dinu Gheorghiu and Barbu	E	1
Potts Ltd	E	1
Ms. Shaheen Ptla	I	1
M Inc	E	1
Rittal Aba	I	1
Viorica Thomas	I	1
"Dabbagh, Al Jaber and Al Bin Zafar"	E	1
Basarab Tomescu	I	1
Matthew Robinson	I	1
Jane Snyder	I	1
"NGO ""Kudryashov"""	E	1
Robin Svoboda	I	1
Horakova Procházková o.s.	E	1
Thompson and Sons	E	1
"Miller, Clark and Bishop"	E	1
Soft crown of Business Information Ltd.	E	1
"Brown, Brooks and Farmer"	E	1
Peter Svoboda	I	1
Andrea Carson	I	1
Bolshakova Cyrus D.	I	1
Blake and Sons	E	1
Susan Johnson	I	1
Leos Moravec	I	1
Johnson Ltd	E	1
Engineered Kawthar Buqshan	I	1
"En Ti Information Co., Ltd."	E	1
Jackson-Jefferson	E	1
Dusek Dusek o.s.	E	1
"Edwards, Fry and Ali"	E	1
Demian Evseevich Knyazev	I	1
Professor Thoroughbred Buqshan	I	1
Elizabeth Nemcova	I	1
Nusseibeh Ptla	I	1
Edwards-Lewis	E	1
Milada Vlčková	I	1
Aaron Gardner	I	1
"Collins, Black and Stephens"	E	1
Leroy Petersen	I	1
Tereza Kolarova	I	1
Uralkali	E	1
Thomas Hanson	I	1
Inspired by Al Bin Zafar	I	1
Dr. Jaafar Al rakish	I	1
Butler Ltd	E	1
Amanda Nunes	I	1
Subbotina Angela Afanasyevna	I	1
Founder Technology Network Ltd.	E	1
Pospisil Sedláček Ltd.	E	1
Ms. Eleanor Khan	I	1
"IP ""Petrova-Horns"""	E	1
Stacie George	I	1
Lucretius Oprea	I	1
Junaidi PLC	E	1
Jeffrey Walker	I	1
Walker Group	E	1
"Tianyi Communication Co., Ltd."	E	1
Vladislav Larionov Terent'evich	I	1
"Hancock, Savage and Colon"	E	1
Anderson Group	E	1
Fang Lili	I	1
"And the Thai Network Co., Ltd."	E	1
Zhao	I	1
Sean Jensen	I	1
Aura Florea	I	1
Sophie Patel	I	1
Alyssa Wheeler	I	1
Dr. Gordon Jackson	I	1
Allison-Wright	E	1
Husseini PLC	E	1
Dr. Alice Grant	I	1
Morris-Rice	E	1
"Howard, Thornton and Boyd"	E	1
Dr. Shaheen Dahi	I	1
Dr. Annette Mitchell	I	1
Aref Ilarionovichh Dementiev	I	1
Kveta Svobodová	I	1
Mike Sanchez	I	1
Mr. Sadr al-Din Mahyar	I	1
Klein Ltd	E	1
Hudson Group	E	1
Vlasta Beranová	I	1
Tyler Williams	I	1
Husseini-Dlahh	E	1
Preda Inc	E	1
Dr. Al Mokth Lebanon	I	1
"Henderson, May and Weaver"	E	1
Adela Stanescu	I	1
Engineer Abdel Tawab Muhanna	I	1
Al Jaber PLC	E	1
Yao Shulan	I	1
"Badr, Toukan and Xuana"	E	1
Mary Robinson	I	1
Alekseev Izjaslav Daniilovich	I	1
Nadezhda Bartošová	I	1
Marian Mazilescu	I	1
Kratochvil Inc.	E	1
Akulina Nikiforovna Kopylova	I	1
Petra Kucerova	I	1
Drahomíra Purple	I	1
"Sea Technology Media Co., Ltd."	E	1
"Year of the Century Media Co., Ltd."	E	1
"Dlahh, Marmash and Nashashibi"	E	1
Lisa Thompson	I	1
"Husseini, Tarabin and tick"	E	1
Engineer Conditioner Al Bin Zafar	I	1
Miller LLC	E	1
Joel Mccullough	I	1
Soukupová Holub Ltd.	E	1
Liu Li	I	1
Theodor Gheorghiu	I	1
Kratochvil	E	1
Salhi Ltd	E	1
Good good	E	1
Helena Jandová	I	1
"Beat Information Co., Ltd."	E	1
Virginia Ene	I	1
Sylvester V. Sazonov	I	1
Patty Glass	I	1
Emily Clements	I	1
Angelina Romanova Nikolaev	I	1
Jakub Dolezal	I	1
Dima Nicoara	I	1
Muhammad bin Ali bin Awad Al-Jammaz	E	1
Ladislav Novák	I	1
Duarte-Pearson	E	1
Wang Hao	I	1
Khammash-Dlahh	E	1
Gabriel Gheorghiu	I	1
Dr. Al Gilan Bin Zafar	I	1
"Robinson, Tucker and Rush"	E	1
Bernard-Scott	E	1
Mitshael Freedom	I	1
Al Mohammed Bin Ali Bin Jammaz LLC	E	1
Al-Awad Bin Al Wafi	E	1
Lopez Inc	E	1
Mr. Makki tractor	I	1
Andrew Cooper	I	1
Dr. Dorothy Henderson	I	1
"Salehi, Xuana and Shaheen"	E	1
Elizabeth Lynch	I	1
Albu Group	E	1
"And the Thai Network Co., Ltd."	E	1
Darren Gregory	I	1
Markova Ltd.	E	1
Joyce Reynolds	I	1
"Al Safwan, Al-Aqeel and Atfet"	E	1
Pestovo Maya Feliksova	I	1
Fitzgerald Ltd	E	1
Cline-Smith	E	1
"NGO ""Kondratieff"""	E	1
"Valencia, Shelton and Huber"	E	1
"Brown, Peterson and Hudson"	E	1
Merida	E	1
Axinte Stanescu	I	1
Ryan-Bryan	E	1
"A billion Media Co., Ltd."	E	1
Liu Xiuyun	I	1
Evan Schultz	I	1
Despina Ababei	I	1
Iuliu Popescu	I	1
Walid Abu Dawood	I	1
Aglaia Diaconescu	I	1
Manole LLC	E	1
Al military and Sons	E	1
Merkushev Incorporated	E	1
Helen Ryan	I	1
Naumova Akulina Robertovna	I	1
"Ellison, Blackwell and Lee"	E	1
Komarova Love Timurovna	I	1
Richard Moravec	I	1
Radomir Hájek	I	1
Humbled Muhammad bin Ali bin Jammaz	I	1
Blaha	E	1
Turkmen and Sons	E	1
Section Jianping	I	1
Justin Thompson	I	1
Davison Ltd	E	1
"Xiangfan Global Village Media Co., Ltd."	E	1
Muhanna Al-Jafar	E	1
"Carter, Contreras and Stewart"	E	1
Thomas and Sons	E	1
Munif Al Safwan	I	1
Mr. Rustam Al-Saud	I	1
"The new Green Knight Media Co., Ltd."	E	1
Georgescu Inc.	E	1
"Jan, Toma and Popa"	E	1
Abu-tractor Hqdm	E	1
"Xiangfan Global Village Media Co., Ltd."	E	1
Troy Galvan	I	1
Ksenia Maximova Tarasovna	I	1
Popescu Popescu and Nistor	E	1
Green-Harrison	E	1
Savelyev Silanty Demidovich	I	1
Charles Mercado	I	1
Christina Johnson	I	1
Al-Sharbatly Military	E	1
"Fatayer, Fatayer and Dughmosh"	E	1
"FE ""Potapova, Dementiev and Pakhomov"""	E	1
Mr. Al-breaker Khudair	I	1
Dr. Al Jaber Arabic	I	1
Panbo	I	1
Bahia Alshaya	I	1
Elizabeth Vaňková	I	1
Easy Engineer Al Short	I	1
Alexandr Blažek	I	1
Rose Hall	E	1
Nelson Ltd	E	1
"YinJia Technology Co., Ltd."	E	1
Daria Boleslavovna Bykov	I	1
Vaughan-Smith	E	1
Hortensia Popa	I	1
Dvorakova Ltd.	E	1
Dobroslav Valentinovič Shashkov	I	1
Lewis-Silva	E	1
Zhang-Castro	E	1
Marcel Nistor	I	1
Teacher Kay	I	1
Ponomarev Proclus Venediktovich	I	1
Al-Sultan Al-Mokth	E	1
Ms. Nawal Shaheen	I	1
Radovan Horák	I	1
Lucie Sedláčková	I	1
Jitka Blažková	I	1
Nikol Vlčková	I	1
Last Marine	I	1
Thomas Peck	I	1
Mr. Anthony Parsons	I	1
Clifford Simpson	I	1
Payne Group	E	1
Miss Lebanon Hajjar	I	1
Thaddeus Vesely	I	1
Brittany Baker	I	1
"NGO ""Denisov-Nikolaev"""	E	1
Kevin Hoffman	I	1
Charles Wheeler	I	1
Eftimia Nistor	I	1
"Acevedo, Alvarado and Galvan"	E	1
Brown-Harris	E	1
Professor Abu Amar and attributes	I	1
Al-Dabbagh Bin Avi	E	1
Kopecká	E	1
